








NO textures/texture_0.xpm
SO textures/texture_1.xpm
EA textures/texture_3.xpm
WE textures/texture_2.xpm


      F        200,100,0     

C 0,30,100

	



			
	1111111111111111111111111
	1000000000110000000000001
	1011000001110000000000001
1001000000000000000000001
1111111110110000011100001
1000000000110000011101111
1111011111111101110000001
1111011111111101110101001
1100000011010101110000001
100000000000000011000		11111
1000000000000000110000001
11000001110101000000N0111
1111011111101011010000101
11111111111111   1111111
