






      F        200,100,0     


C 0,30,100
WE textures/texture_2.xpm
NO textures/texture_0.xpm
EA textures/texture_3.xpm
SO textures/texture_1.xpm




	



			
    1111111111111111111111111			
    1000000000110000000000001
    1000000000110000000000001
    1011000001110000000000001
    1001000000000000000000001
    1111111111111111111111111
    1111111111111111111111111
    1111111110110000011100001
    1000000000110000011101111
    1111011111111101110000001
    111101111111110111010100111
111111111000000110101011100000011111111
100000000000000000000000000000000000001
100000000000000000000000000000000000001
111111111000001110101000000N01111111111
    1111011111101011010000101
    111111111111111111   1111111    
