

C 0,30,100


SO                                      textures/texture_1.xpm
      NO 					textures/texture_0.xpm     		
EA textures/texture_3.xpm			
      F        200,100,212    
WE textures/texture_2.xpm	     





1111111
1110001
111S111
1111111
